##################
#S     #     #   #
#   ####     ##  #
###   #    ###   #
#     # #   #    #
#       #       F#
##################